**************************************
*....................................*
*....................................*
*....................................*
*....................................*
*....................................*
*....................................*
*....................................*
*.................................E..*
*.........***......*******************
*...S..............*******************
**************************************